111111111111111111111111111111111111111111111111111111111111
1P000000000000000000000000010000000000000000000000000000C001
100000000000000000000000000100000000000000000000000000000001
1000000000C000000000000000010000000000000CCCCCCCC00000000001
100000000000X00000000000000100000000000000000000000000000001
100000000100000000100000000000000000000000000000000000000001
100000000100000000100000000000000000000000000000000000000001
100000000100000000100000000000000000000000000000000000000001
100000000100000000100000000000000000000000000000000000000001
111110000100000000000000000011111111111111111111110000000001
100000000100000000000000000100000000000000000000000000000001
100000000100000000000000000100000000000000000000000000000001
100000000100000000000000000100000000000000000000000000000001
1000000001000000CCCCCCCC0001000000000E0000000000000000000001
100000000000000000100000000100000000100001000000000000000001
100000000000000000100000000100000000000001000000000000000001
100000000000000000100000000100000000000001000000000000000001
100000000000000000100000000100000000000001000000000000000001
100001111111110000100000000000000000000001111111111000011111
100000000000000000100000000000001000000001000000001000000001
100000000000000000100000000000001000000001000000001000000001
10000000000000000010000000000000100000000100000000100C000001
10000000000000000010000EC00000001000000001000000001000000001
100000000100001000000000000000001000000001000000000000000001
100000000100000000111111111100001000000001000000000000000001
10000000010000000000000000000000100C000001000000000000000001
1000000001000000000000000000000010000000010000C0000000000001
100000001111111111111111110000001000000001000000000000000001
100000000000000000000000000000001000000001000000000000000001
100000000000C00000000000000000001000000001000000000000000001
100010000000000000000001000000001000000001000000000000000001
1000000001000000000000010000000010000000010000C0001000000001
100000000100000000C00000000000001000000001000000001000000001
1000000001000000000000000000000010000000010C0000001000000001
100000000100000000000000000000001000000001000000001000000001
100001111111111111000000000011111000011111111111111000000001
100000000000000000000000000000001000000000000000000000000001
100000000000000000000000000000001000000000000000000000000001
100000000000000000000000000000001000000000000000000000000001
1000000000000000000C0000000000001000000000000000000000000001
1000000000C0000000000000000000000000000001000C00000000000001
100000000000000000000000000000000000000001000000000000000001
1000000000000000000000000000000000000C0001000000000000000001
1E0000000000000000000000000000000000000001000000000000000001
111111111111111111111111111111111111111111111111111111111111